type	Microarray
readType	NA
dataDir	dataset/sampleDataset
outDir	result/sampleResult
GRNFilePath	hsa/GRN.txt
PINFilePath	hsa/PPI.txt
species	hsa
downloadFiles	no
KEGGGeneFilePath	hsa/KEGG_GeneSymbols.txt
KEGGPathFilePath	hsa/KEGG_PathwayList.txt
xmlFilePath	hsa/xmlFiles
single	1
countFile	NA
groupFile	group.txt
geneConvFile	gene_conv.txt
numTP	6
threshold	0.05
maxDelay	1
removeT0	0
FDR	1
k	20
